20 9
s#..................
.#............#.....
.####..#......#.....
....#..#......#.....
....#..#......#.....
.......#..######....
....#######...#g....
............######..
########............
