20 20
s#..................
.#..................
.####..#............
....#..#............
....#..#............
.......#............
.......#............
.......#............
########............
....................
.....###############
..........g.........
....................
....................
....................
....................
....................
....................
....................
....................
